2	2	2	2	2	2	2	2	2	
2	0	2	0	2	0	0	0	2	
2	2	0	0	0	0	2	2	2	
2	0	0	2	2	0	0	0	2	
2	0	2	0	1	2	2	0	2	
2	0	2	0	2	0	0	0	2	
2	0	2	0	2	2	0	2	2	
2	0	0	0	0	2	0	3	2	
2	2	2	2	2	2	2	2	2	
5	5	8	8	